NO test_files/north.xpm
SO test_files/north.xpm
WE test_files/north.xpm
EA test_files/north.xpm

F 11,11,1
C 11,110,1

11111111111
10000000001
10000000001
1000W000001
10000000001
10000000001
10000000001
11111111111
