NO 1.xpm
SO 1.xpm
WE 1.xpm
EA 1.xpm

F 11,11,1
C 11,11,1

1111  1
1W01 101
1111 11