NO test_files/north.xpm
SO test_files/south.xpm
WE test_files/west.xpm
EA test_files/east.xpm

F 256,0,1
C -1,0,3

111111111111111
100000000000001
100000000010001
1000N0000001001
100000000000001
100000000000001
100000000000001
111111111111111
