NO test_files/north.xpm
SO test_files/south.xpm
WE test_files/west.xpm
EA test_files/east.xpm

F 11,11,1
C 11,110,1

111111111111111
100000000000001
100000000100001
1000N0000001001
100000000000001
100000000000001
100000000000001
111111111111111
