C 11,110,1
EA test_files/east.xpm
SO test_files/south.xpm
F 11,11,1
WE test_files/west.xpm

NO test_files/north.xpm

111111111111111
100000000000001
100000000010001
1000N0000001001
100000000000001
100000000000001
100000000000001
111111111111111
